██████████
██████████
█         
███████ █ 
█     █ █ 
█ ███ ███ 
█   █P█   
███ ███ █ 
█         
████████E█
