████████████
██ █       E
██ █ █████ █
██   █ █   █
██ ███ █ ███
██   █ █   █
████ █ ███ █
██     █   █
██ █████ ███
██ █P  █   █
██ ███ ███ █
██   █     █
